11111111111111
10003000000041
10111111101111
10000000100001
11111010101011
14000010001001
10111111111101
10000300000001
10111110111111
10000000000041
11111011101111
10000014100001
10000000000301
11111111111111