11111111111111
10000000000001
10111011111101
10140000000001
10111110111101
10000000300001
11111101101111
10000001000001
10111111011101
10300000000301
10111011111111
10000040000041
10000000000001
11111111111111